introduction	Introduction	root
hardware-and-os	Hardware and OS	introduction
getting-help	Getting help	introduction
getting-easygp	Getting EasyGP	root
arch	Arch	getting-easygp
debian	Debian	getting-easygp
redhat	Redhat	getting-easygp
downloading-easygp	Downloading EasyGP	getting-easygp
building-your-database	Building your database	getting-easygp
manual-build-of-database	Manual build of database	building-your-database
setup-wizard	Setup Wizard	getting-easygp
using-the-wizard	 Using the Wizard	setup-wizard
licence-agreement	 Licence Agreement	setup-wizard
your-practice-details	 Your Practice Details	setup-wizard
the-system-administrator	 The System Administrator	setup-wizard
previewing-your-setup	 Previewing your setup	setup-wizard
completing-the-initial-setup	Completing the initial setup	setup-wizard
importing-data	Importing data	getting-easygp
starting-easygp	Starting EasyGP	getting-easygp
closing-easygp	Closing EasyGP	getting-easygp
basic-concepts	Basic Concepts	root
focus	Focus	basic-concepts
keyboard-navigation	Keyboard Navigation	basic-concepts
interface-design	Interface Design	basic-concepts
splitters	Splitters	interface-design
side-panels	Side Panels	interface-design
the-edit-area	The Edit Area	interface-design
column-widths-for-lists	Column Widths for Lists	interface-design
fonts	Fonts	interface-design
auditing	Auditing	basic-concepts
permissions	Permissions	basic-concepts
selecting-program-sections	Selecting Program Sections	basic-concepts
contacts-manager	Contacts Manager	root
allocating-categories	Allocating Categories	contacts-manager
add-contact-method	Add Contact Method	contacts-manager
adding-addresses	Adding Addresses	contacts-manager
adding-a-photograph	Adding a Photograph	contacts-manager
patients	Patients	contacts-manager
patient-demographic-details	Patient Demographic Details	patients
finding-patients	Finding Patients	patients
importing-patients	Importing Patients	patients
exporting-patients	Exporting Patients	patients
practice-staff	Practice Staff	contacts-manager
staff-demographic-details	Staff Demographic Details	practice-staff
selecting-a-workplace	Selecting a Workplace	practice-staff
logon-and-security	Logon and Security	practice-staff
preferences---providers	Preferences - Providers	practice-staff
other-contacts	Other Contacts	contacts-manager
organisations	Organisations	other-contacts
adding-an-organisation	Adding an Organisation	other-contacts
adding-a-branch	Adding a Branch	other-contacts
other-people	Other People	other-contacts
admin	Admin	root
data-import	Data Import	admin
coding---importing	Coding - Importing	data-import
coding---set-default	Coding - Set Default	data-import
coding---icpc	Coding - ICPC	data-import
coding---icd10	Coding - ICD10	data-import
demographic-data	Demographic Data	data-import
postcodes	Postcodes	data-import
export-data	Export Data	admin
global-request-ordering-defaults	GLobal Request Ordering Defaults	export-data
setting-up-providers	Setting up Providers	admin
global-request-ordering-defaults	GLobal Request Ordering Defaults	setting-up-providers
maintaining-requests	Maintaining Requests	setting-up-providers
global-preferences	Global Preferences	admin
clinical	Clinical	root
main-clinical-screen	Main Clinical Screen	clinical
main-toolbar	Main Toolbar	clinical
finding-a-patient	Finding a Patient.	main-toolbar
consultation-types	Consultation Types	main-toolbar
toolbar-buttons	Toolbar Buttons	main-toolbar
the-section-list	The Section List	main-toolbar
patient-photo	Patient Photo	main-toolbar
useful-patient-details	Useful Patient Details	main-toolbar
allergies-list	Allergies List	main-toolbar
recalls-summary	Recalls Summary	main-toolbar
the-medical-record	The Medical Record	clinical
problem-oriented-records	Problem Oriented Records	the-medical-record
coding-systems	Coding Systems	the-medical-record
accuracy-of-data-entry	Accuracy of Data Entry	the-medical-record
health-issues	Health Issues	clinical
health-issue-edit-area	Health Issue Edit Area	health-issues
terms-and-coding	Terms and Coding	health-issues
historical-summary	Historical Summary	health-issues
management-plan-summary	Management Plan Summary	health-issues
care-plan-providers	Care Plan Providers	health-issues
editing-health-issues	Editing Health Issues	health-issues
deleting-a-health-issue	Deleting a Health Issue	health-issues
audit-trail-for-health-issues	Audit Trail for Health Issues	health-issues
progress-notes	Progress Notes	clinical
the-notes-editor	The Notes Editor	progress-notes
entering-notes	Entering Notes	progress-notes
entering-measurements	Entering Measurements	progress-notes
viewing-graphs	Viewing Graphs	progress-notes
write-a-medical-certificate	Write a Medical Certificate	progress-notes
inserting-a-diagram	Inserting a Diagram	progress-notes
inserting-an-image	Inserting an Image	progress-notes
allergies	Allergies	clinical
care-planning	Care Planning	clinical
certificates	Certificates	clinical
the-drawing-editor	The Drawing Editor	clinical
family-history	Family History	clinical
fh-add-or-change	FH Add or Change	family-history
delete-condition	Delete Condition	family-history
importing-family-history	Importing Family History	family-history
immunizations	Immunizations	clinical
mental-health	Mental Health	clinical
occupational-history	Occupational History	clinical
pregnancy	Pregnancy	clinical
prescribing	Prescribing	clinical
recalls	Recalls	clinical
recall-edit-area	Recall Edit Area	recalls
new-recall	New Recall	recalls
templates	Templates	recalls
adding-an-attatchment	Adding an Attatchment.	recalls
toolbar-recalls	Toolbar Recalls	recalls
popup-recalls-menu	Popup Recalls Menu	recalls
sending-recalls	Sending Recalls	recalls
recall-audit-trail	Recall Audit Trail	recalls
requests	Requests	clinical
referrals	Referrals	clinical
the-scratch-pad	The Scratch Pad	clinical
modifying-the-scratchpad	Modifying the Scratchpad	the-scratch-pad
scratchpad-audit	ScratchPad Audit	the-scratch-pad
social-history	Social History	clinical
workcover	Workcover	clinical
claims	Claims	workcover
calendar	Calendar	workcover
visits	Visits	workcover
drug-browser	Drug Browser	clinical
the-inbox	The Inbox	root
preferences	Preferences	the-inbox
messaging-software	Messaging Software	preferences
work-flow	Work Flow	the-inbox
the-result	The Result	work-flow
user-synonyms	User Synonyms	work-flow
filing-normal-results	Filing Normal Results	work-flow
adding-a-progress-note	Adding a Progress Note	work-flow
adding-a-recall	Adding a Recall	work-flow
adding-a-request	Adding a Request	work-flow
notifying-a-task	Notifying a Task	work-flow
adding-a-scratchpad-item	Adding a ScratchPad Item	work-flow
making-an-appointment	Making an Appointment	work-flow
troubleshooting	Troubleshooting	the-inbox
the-library	The Library	root
my-library	My Library	the-library
patient-handouts	Patient Handouts	the-library
internet-resources	Internet Resources	the-library
favourites	Favourites	the-library
licencing	Licencing	root
easygp-source-code	EasyGP Source Code	licencing
icpc2-2-plus-codes	ICPC2-2 Plus Codes	licencing
icd-10-codes	ICD-10 Codes	licencing
postgresql-database	PostgreSQL Database	licencing
